{
  "title": [
    "Test Level",
    "10x10"
  ],
  "titleFont": "Graceful",
  "titleSound": "sounds/door-slammed.mp3",
  "author": "Iroknee",
  "objective": "Test Your Maze!",

  "map": [
    "+---+---+---+---+---+---+---+---+---+---+",
    "|   |       |                   |       |",
    "+-o-+   +   +   +       +---+   +---+   +",
    "|       |       |           |           |",
    "+---+---+---+---+---+-o-+   +---+---+   +",
    "|           |       |   |   |           |",
    "+   +---+   +   +   +---+   +   +---+---+",
    "|       |       |   |       |   |       |",
    "+---+   +---+---+   +   +---+   +   +---+",
    "|       |               |   |   |       |",
    "+   +-o-+---+---+---+---+-o-+   +-o-+   +",
    "|   |   |       |       |       |   |   |",
    "+   +---+   +   +---+   +   +---+---+   +",
    "|           |       |   |           |   |",
    "+---+---+---+---+   +   +---+---+   +   +",
    "|               |   |           |   |   |",
    "+   +---+---+-o-+   +---+   +   +   +   +",
    "|           |   |       |   |   |   |   |",
    "+   +---+   +---+---+---+   +   +   +   +",
    "|       |                   |           |",
    "+---+---+---+---+---+---+---+---+---+---+"
  ],
  "objectPositions": [
    "+---+---+---+---+---+---+---+---+---+---+",
    "| ^ | 5     |                   |     8 |",
    "+-o-+   +   +   +       +---+   +---+   +",
    "|       | b     |           |           |",
    "+---+---+---+---+---+-o-+   +---+---+   +",
    "|           |       |   | 9 |           |",
    "+   +---+   +   +   +---+   +   +---+---+",
    "|       |       |   |       |   |     3 |",
    "+---+   +---+---+   +   +---+   +   +---+",
    "|       |         e     | 5 |   |       |",
    "+   +-o-+---+---+---+---+-o-+   +-o-+   +",
    "|   |   |       |     5 |       |   |   |",
    "+   +---+   +   +---+   +   +---+---+   +",
    "| 2         |     a |   |           |   |",
    "+---+---+---+---+   +   +---+---+   +   +",
    "|               |   |         5 |   | 5 |",
    "+   +---+---+-o-+   +---+   +   +   +   +",
    "| 6   c   0 |   |     7 |   |   | 4 |   |",
    "+   +---+   +---+---+---+   +   +   +   +",
    "|       |     1             |     d   v |",
    "+---+---+---+---+---+---+---+---+---+---+"
  ],
  "objectKeyMappings": {
    "0": {
      "object": "bandage"
    },
    "1": {
      "object": "bone-knife"
    },
    "2": {
      "object": "bone"
    },
    "3": {
      "object": "book"
    },
    "4": {
      "object": "cordage"
    },
    "5": {
      "object": "darkness"
    },
    "6": {
      "object": "grass"
    },
    "7": {
      "object": "map"
    },
    "8": {
      "object": "mushroom"
    },
    "9": {
      "object": "sarcophagus"
    },
    "o": {
      "object": "door-unlocked"
    },
    "^": {
      "object": "ladder-up"
    },
    "v": {
      "object": "ladder-down"
    },
    "a": {
      "object": "stick"
    },
    "b": {
      "object": "torch"
    },
    "c": {
      "object": "twine"
    },
    "d": {
      "object": "vines"
    },
    "e": {
      "object": "giant-spotted-egg"
    }
  }
}